11111111111111111111
10000000000000000001
10000000000000000001
10000000000000000001
10000000000000000001
10000000000000000001
10000000022000000001
10000002222220000001
10000002022220000001
10000002002200000001
10000002000000000001
10000002000000000001
10002222000000000001
10002000000000000001
12222000000000000001
10000000000000000001
10000000000000000001
10000000000000000001
10000000000000000001
11111111111111111111